 ###########
##    #    ##
# .$$. .$$. #
# $..$ $..$ #
# .$$...$$. #
# $..$ $..$ #
## $$.*.$$ ##
# $..$ $..$ #
# .$$...$$. #
# $..$ $..$ #
# .$$.@.$$. #
##    #    ##
 ###########
