#######
#  @  #
# $.$ #
##.$.##
## $ ##
# $.$ #
# .$. #
# .$. #
#  #  #
#######
