  ###### ######
 #     ###     #
# .$.$. # .$.$. #
# $.$.$ # $.$.$ #
# .$.$ ### $.$. #
# $.$.#    .$.$ #
# .$  #$ $## $. #
##  # $...$ #  ##
 ####  .@.  ####
##  # $...$ #  ##
# .$ ##$ $#  $. #
# $.$.    #.$.$ #
# .$.$ ### $.$. #
# $.$.$ # $.$.$ #
# .$.$. # .$.$. #
 #     ###     #
  ###### ######
