  ########
  #      #
###*####.#
#    $ $ #
# #......###
# #$ #     #
# #. #@# # #
# $$## #$# #
#  $   $   #
#  #########
####
