 #########
 #   #   #
## # # # ##
# *.*$*.* #
#    #    #
### $@$ ###
#    #    #
# *.*$*.* #
## # # # ##
 #   #   #
 #########
