#######
#     ####
# # # .  ##
# $$$**$$ #
#....@....#
# $$**$$$ #
##  . # # #
 ####     #
    #######
