    #####
 ####   #
 #  $$# #
## *..$ #
#@ .#.  #
# $..* ##
# #$$  #
#   ####
#####
