   #####
   #   #
#### # #
# . .# #
#  .   #
# .## $##
##  #$$ #
 ##   $@#
  ##  ###
   ####
