#############
#     #     #
# # #   # # #
#  .$.$.$.  #
# #$.$.$.$# #
#  .$.$.$.  #
# #$.$@$.$# #
#  .$.$.$.  #
# #$.$.$.$# #
#  .$.$.$.  #
# # # # # # #
#     #     #
#############
