           #
 # ######## #
  #        #
 # *$.$.$* #
 #  *###*  #
 # $#   #$ #
 #.. .@. ..#
 # $#   #$ #
 #  *###*  #
 # *$.$.$* #
 #        #
# ######## #
 #
