  ########
  # #   ##
##### # ####
# $ $$ $ $ #
#..........#
# $ $ $$ $ #
#### # #####
  ## @ # #
  ########
