        ######
####### #    ##
#     ### ##  ##
# #  $.##$  #  ##
#  #  *.@.*  #  #
##  #  $##.$  # #
 ##  ## ###     #
  ##    # #######
   ######
