     #####
     #   ###
  ####     ##
###   #.##  ##
#  $ $ $ $$@ #
#  # ##.##   #
## # # . #####
#  # ...*.   #
# $###   #   #
# $   ###  ###
#   #     ##
###########
