     #####
     #   #####
     # # #   #####
     #     # #   #
  #####$#      #$#
  # $  $ ####$   #####
  # # #     # ## #   #
  #   ##### # # $$ # #
 ### $      #@#  #   #
 #   ####.... # #  ###
 # # #   .... # #   #
 #   # # ....   # # #
###  # # ....####   #
#   #  # #      $ ###
# # $$ # # #####   #
#   # ## #     # # #
#####   $#### $  $ #
    #$#      #$#####
    #   # #     #
    #####   # # #
        #####   #
            #####
