##############
#      #  #  ####
# #### #  @   . #
# $.....  #  #$ #
##$#####  # ##. #
 #      ###   $ #
 # ## $  ## ##  #
## ### $    #####
# $  #  #####
#    ####
###  #
  ####
