  #####
###   ##
# $$.. #
# . @# #
## #   #
 # *$ ##
 ###  #
   ####
